32 31 13
###############################
#$  **** ** * *     *  *     *#
# #1# #*# # # # # # # # #*# # #
#   **   * * *   * * *  *  *  #
# #*# #*# # # # # #*# # # #*# #
#    *   2b**  * * *** 7 * 1**#
#*# #1#1#*# #*# # # # # # #*# #
# * *  *p*    *    * * * * *  #
#*# # # # # # #1# # #*# #*# #*#
#     ***  *     *5 **f* **   #
# #*# # # # #*#*# # # #*# # #*#
# **  ***  **s**  f    *  * * #
###############################