32 31 13
###############################
#$  **** ** * *     *  *     *#
# #1# #*# # # # # # # # #*# # #
#   **   * * *   * * *  *  *  #
# #*# #*# # # # # #*# # # #*# #
#    *    b**  * * ***   * 1**#
#*# #1#1#*# #*# # # # # # #*# #
# * *  *p*    *    * * * * *  #
#*# # # # # # #1# # #*# #*# #*#
#     ***  *     *  **f* **   #
# #*# # # # #*#*# # # #*# # #*#
# **  ***  **s**  f    *  * * #
###############################