32 31 13
###############################
#$ p**** ** * *     *  * 6   *#
# * #6#*# # # # # # # # #*# # #
# 1 **   * * *   * * *  *  *  #
# #*# #*# # # # # #*# # # #*# #
#    *    b**  * * ***   *  **#
#*# # # #*# #*# # # # # # #*# #
# * *  * *  6 *    * * * * *  #
#*# # # # # # # # # #*# #*# #*#
# 6   ***  *     *  **f* **   #
# #*# # # # #*#*# # # #*# # #*#
# **  ***  **s**  f  6 *  * * #
###############################