32 31 13
###############################
#    $  p                     #
#                             #
#                             #
#                             #
#                     *       #
#                             #
#                             #
#                             #
#                             #
#                             #
#                             #
###############################