32 31 13
###############################
#   p***     * *  *  *  *    7#
# * # #*# # # # # # # # #*# # #
#   **   * * *  ** * *  *  *  #
# #*# #*# # # # # #*# # # #*# #
#    s    b**  * * ***   * ***#
#f# #1# #*# #*# # # # # # #*# #
# *    * *    *    * * * * *  #
#*#*# # # # # # # # #*# #*# #*#
#     ***      $    **   **   #
# #*# # # # # #*# # # #*# # #*#
# *** ***  *****       *  * * #
###############################