32 31 13
###############################
#   p***     * *  *  *  *    8#
# * # #*# # # # # # # # #*# # #
#   **   * * *  ** * *  *  *  #
# #*# #*# # # # # #*# # # #*# #
#    s    b**  * * *** 8 * ***#
#f# # # #*# #*# # # # # # #*# #
# *    * * f  *    * * * * *  #
#*#*# # # # # # # # #*# #*# #*#
#     ***  bbDb$ WF **   **   #
# #*# # # # # #*# # # #*# # #*#
# *** ***  *****       *  * * #
###############################