32 31 13
###############################
#    ***     * *  *  * 3*     #
# p # #F# # # # # # # # #*# # #
#   WB   * * *  ** * *  *  *  #
# #s# #D# # # # # #*# # # #*# #
#         b**  * * *** 2 * ***#
#f# #1# #*# #*# # # # # # #*# #
# M    * * 5  *    * * * * *  #
#*#*# # # # # # # # #*# #*# #*#
#     ***       4   **   **   #
# #*# # # # # #*# # # #*# # #*#
# *** ***  *****       *  * * #
###############################