32 31 13
###############################
#$  p*** 454 * *  *  *  *     #
# * # #*# # # # # # # # #*# # #
#   **2  * * *  ** * *  *  *  #
# #*# #*# # # # # #*# # # #*# #
#    s    b**2 * * ***   * ***#
#f# #1# #*# #*# # # # # # #*# #
# * 4  * * 1  *    * * * * *  #
#*#*# # # # # # # # #*# #*# #*#
#     *** 3   2  41 **3  **   #
# #*# # # # # #*# # # #*# # #*#
# *** ***  *****  5    *  * * #
###############################