32 31 13
###############################
#    ***     * *  *  *  *     #
# * # #*# # # # # # # # #*# # #
#   **   * * *  ** * *  *  *  #
# #*# #*# # # # # #*# # # #*# #
#         b**  * * ***   * ***#
#f# #1# #*# #*# # # # # # #*# #
# *    * *    *    * * * * *  #
#*#*# # # # # # # # #*# #*# #*#
#     ***           **   **   #
# #*# # # # # #*# # # #*# # #*#
# *** ***  *****       *  * * #
###############################