32 31 13
###############################
#  **1   *** 2   **1   * 1 ***#
#  *# #*# #*# #*# # # #1#*# # #
#*    * 1     *s*1   *p*  b** #
# # #*#2#*#*#1# # #*#*# # # # #
# 1****     1 *  **   **   2  #
#*# # #*# # # #*# #*# #1# # # #
#  1  **  **f   1  ** 1 * **  #
# #*# #*# #*#*#2# # # #1# # # #
#  * *    * **     **1     ** #
# #*# #*# # # #*# #*#1# # # # #
#  1  * * * * $ **    1***   *#
###############################