32 31 13
###############################
#    ***     * *  *  *  *     #
# p # #F# # # # # # # # #*# # #
#   WB   * * *  ** * *  *  *  #
# #s# #D# # # # # #*# # # #*# #
#  P      b**  * * ***   * ***#
#f# # # #*# #*# # # # # # #*# #
# M    * *    *    * * * * *  #
#*#*# # # # # # # # #*# #*# #*#
#     ***           **   **   #
# #*# # # # # #*# # # #*# # #*#
# *** ***  *****       *  * * #
###############################