32 31 13
###############################
#$   *b**  1   * *    2  **   #
#*  # # # #*# #p# #*# #*#*#*# #
# ***  1  * 3  *   **  1      #
#*#*# #*# # # #1# # #*# # #*#*#
# *  *  2  *s*   ** 1*   **   #
# # #*#*# # # #*# # # #7# #*# #
#   B*    * 1  **  1  **f*    #
#*# #*#*#4#*# # # # # # # #*# #
#*  *    **  * 1  **   *   1  #
# #*# #*# # #*#*# #*# #*# # # #
#    1  * 2   *D*   * 1  ***  #
###############################