32 31 13
###############################
#$         1 I                #
#            I                #
# p          I                #
#            I                #
#            I                #
#            I                #
#                             #
#                             #
#                             #
#                             #
#                             #
###############################