32 31 13
###############################
#$  *  *1  *  3  **    2   *s #
# #*# # #*# #*# #*# #*# # # #*#
#   *W*  1   *   1   *  4 * * #
#*#*#*# #*# #*# # # #*# #*# #*#
# *  *1   5  *b*       *   8* #
# # #f# #*# #*#*# # #*#*# # # #
# 1  *   ** 1  **3    1f*  2 *#
# #*#B# # # #*# # #*# # # # # #
#   2*      **    *D* * * *   #
#*# # # # # #p#*# #*# #*# # # #
#F*   3 ***  *7    *     1*  *#
###############################