32 31 13
###############################
#$   *   **   1  ***     2**  #
#   # #1#*# # #*# #*#*# # # # #
#*   * *  2  *s*     1   **   #
# #*# # # # # # #*# #*# # # #*#
#   1  ***f   ** 2       *1   #
#*# # #3# # # # # # #*#*# # #*#
#  **      1 **B*    4p*   *  #
# #1# #*#*# #*# #*#*# #*# #1# #
#*  2*    ***   1  *   2      #
# # # # # #*# # # #*# # #*# # #
#    * *   2   * * *   1 * 3 D#
###############################