32 31 13
###############################
#$  * * 2*   *    *    1   ** #
#  *#*# # #*# #1#*# # # #s#*# #
# * 1 *   *1**    * 3   **    #
#*# #*# # # #*#*# # #*# # # #1#
#*   * * 2    *p* 1    **     #
# #*# #*# # #*# # #*# # #1#*# #
#   1*   ***   2 *B  * *      #
#*#*# #*# # #*# # # #D#*# # #*#
# *f*   3  *   1 **  *   2 *  #
# #*# # # #s# # # #1# # #*#*# #
#   2 * * *  1   ***    1     #
###############################