32 31 13
###############################
#$  *   ***1  *   * 2  * *  * #
#   # #*# # #*# #*# #*#*# # # #
#**   1  *2 *** 1    *B* 1  * #
# #*# # # #*# #*# # #*# # #*# #
#  *****    1   ****   2  * * #
# # # #*# #*# # # #*# # #*# # #
#    1    1b**   1**  1  **   #
# #*# #*# # #*# # #*# # #*# # #
#  1s**  **1    *  **1   *f*  #
# #*#*# #*# # # # # # # #*#*# #
#* * 1   *2   * ****p *  **   #
###############################