32 31 13
###############################
#$ **    3 *F* 1 *  2     ***p#
#   # #*# #*#*# #*# #*#*# #*#*#
#* **   2 *f*   ***   3 ***   #
# #*#*# #4#*# #1#*# #*# # # #*#
#   * 2    *1   *W*  5    1  *#
#*# #*# # #*# # #*# #*# # #*#*#
# 1  **   8     b*   ** 2  *  #
#*# # # #*# #*#*#*# # #*#*#*# #
#s*   7**D*  1   *   2   *M*  #
#*#*# #*#*#*# # #*# # # #*#*# #
#*     1 *    3 *B*   1  ** 6 #
###############################