32 31 13
###############################
#$  p                         #
# D          1                #
#                             #
#                             #
#         b                   #
#                             #
#                             #
#                             #
#                             #
# #*# # # # #*#*# # # #*# # #*#
#                             #
###############################