32 31 13
###############################
#$   **  *  * *  1  *  *     *#
# # # # # # # # # # # # #*# # #
#   **1  * *    1* *    *  *  #
# #*# #*# # # # # #*# # # #*# #
# 1  * *  b*       * *   * 1* #
#*# # # #*# #*# # # # # # #*# #
# *    *p* 1  *   1* *   * *  #
#*# # # # # # # # # #*# #*# # #
#     **   *  *     **f* **1  #
# #*# # # # #*#*# # # #*# # #*#
#  *1 **    *s**  f   1*  * * #
###############################