32 31 13
###############################
#    ***     * *  *  *  *     #
# p # #*# # # # # # # # #*# # #
#   **   * * *  ** * *  *  *  #
# #s# #*# # # # # #*# # # #*# #
#         b**  * * ***   * ***#
#f# #1# #*# #*# # # # # # #*# #
# *    * *    *    * * * * *  #
#*#*# # # # # # # # #*# #*# #*#
#     ***           **   **   #
# #*# # # # # #*# # # #*# # #*#
# *** ***  *****       *  * * #
###############################