32 31 13
###############################
#    ***     * *  *  *  *     #
# * # #*# # # # # # # # #*# # #
#   **   * * *  ** * * 1*  *  #
# #*#4#*# # # # # #*# # # #*# #
#         b**  * * *** 1 * ***#
#f# #1# #*# #*# # # # # # #*# #
# *    * *    *  4 * * * * *  #
#*#*# # # # # # # # #*# #*# #*#
#     *** 1  5   5  **   **   #
# #*# #1# # # #*# # # #*# #1#*#
# *** ***  *****  4    *  * * #
###############################