32 31 13
1 1 1 1 1 1 1 1 1 1 1 1 1 1 1 1 1 1 1 1 1 1 1 1 1 1 1 1 1 1 1
1 0 0 0 0 3 3 3 0 0 0 0 0 3 0 3 0 0 3 0 0 3 0 0 3 0 0 0 0 0 1
1 0 3 0 1 0 1 3 1 0 1 0 1 0 1 0 1 0 1 0 1 0 1 0 1 3 1 0 1 0 1
1 0 0 0 3 3 0 0 0 3 0 3 0 3 0 0 3 3 0 3 0 3 0 2 3 0 0 3 0 0 1
1 0 1 3 1 0 1 3 1 0 1 0 1 0 1 0 1 0 1 3 1 0 1 0 1 0 1 3 1 0 1
1 0 0 0 0 0 0 0 0 0 5 3 3 0 0 3 0 3 0 3 3 3 0 2 0 3 0 3 3 3 1
1 4 1 0 1 2 1 0 1 3 1 0 1 3 1 0 1 0 1 0 1 0 1 0 1 0 1 3 1 0 1
1 0 3 0 0 0 0 3 0 3 0 0 0 0 3 0 0 0 0 3 0 3 0 3 0 3 0 3 0 0 1
1 3 1 3 1 0 1 0 1 0 1 0 1 0 1 0 1 0 1 0 1 3 1 0 1 3 1 0 1 3 1
1 0 0 0 0 0 3 3 3 0 2 0 0 0 0 0 0 0 0 0 3 3 0 0 0 3 3 0 0 0 1
1 0 1 3 1 0 1 2 1 0 1 0 1 0 1 3 1 0 1 0 1 0 1 3 1 0 1 2 1 3 1
1 0 3 3 3 0 3 3 3 0 0 3 3 3 3 3 0 0 0 0 0 0 0 3 0 0 3 0 3 0 1
1 1 1 1 1 1 1 1 1 1 1 1 1 1 1 1 1 1 1 1 1 1 1 1 1 1 1 1 1 1 1