32 31 13
###############################
#$* * * *  2*f**     ** 1   **#
# # #*#*# # # # # # # # # # # #
#* *    1  3**    1  *D*   *  #
#*#*# #*# # #*#*# # # #*# #*#*#
#    1 *W*     *  * *  4  **  #
# # # #*#*#1# #*# # # # # # # #
#* **   7  *  *s* 2     1     #
# # # #*# #*# #*# #*# #*# # # #
# 1  *     *    1  *     **   #
# #*#b# # #*# # # #*#*# #*# #*#
#     *   **   5   **   2*  *p#
###############################