32 31 13
###############################
#$  *1   *** 2   **    * 1 ***#
# #*# #*# # # #*# # # #1#*# # #
#*    *I1    **s*1   *p*  b** #
#*# #*# #*#*#1# # #*#*# # # # #
# 1    I    1 *  *   I        #
#*# # #*# # # #*# #*# #*# # # #
#  1   *  **f       I 1 * **  #
# #*# #*# #*#*# # # # #1# # # #
#    *  1 *     I  **      ** #
# # # #*# # # #*# #*# # # # # #
#  1  * *     I **    1**    *#
###############################