32 31 13
###############################
#$  *     *    2 **   1*   ***#
# # #*# #*#*# # # #*# #p# #*# #
#* *  1   *s*    **   1*    * #
#*#v#*# # # #*# #*# #*# # # #*#
#*   1**   *   3*B   **    1  #
# # #*# # # # # #*#2#*# # # # #
#  *f*  **  1**   *    *  *   #
#*#*# # # # #*# # #*# #*#1# #*#
# 2 *  **   *      1    **    #
#*# # #b# #*# #*# # #f# # # # #
#**   **  *  1    **  *  1   *#
###############################