32 31 13
###############################
#$  *    **1  *   * 2  * *  * #
# # # #*# # #*# #*# #*#*# # # #
#**   1      ** 1    *B* 1  * #
# #*# # # #*# #*# # #*# # #*# #
#  ***      1   **     2  *   #
# # # #*# #*# # # #*# # #*# # #
#    1    *b**   1**     **   #
# #*# #*# # #*# # #*# # #*# # #
#  1s*  **     *  **1   *f*   #
# #*#*# #*# # # # # # # #*#*# #
#* * 1   *    * ****p *  **   #
###############################