32 31 13
###############################
#$  **** ** * *  1  *  *     *#
# # # #*# # # # # # # # #*# # #
#   **1  * * *  1* * *  *  *  #
# #*# #*# # # # # #*# # # #*# #
# 1  *    b**2 *I* ***   * 1**#
#*# # # #*# #*# # # # # # #*# #
# * *  *p* 1  * I 1* * * * *  #
#*# # # # # # # # # #*# #*# #*#
#     ***  *  1  *  **f* **1  #
# #*# # # # #*#*# # # #*# # #*#
# **1 ***  **s**  f   1*  * * #
###############################