32 31 13
###############################
#$  p            I     I      #
# D          1         I      #
#                      I      #
#                      I      #
#         b                   #
#                             #
#                             #
#      I                      #
#                             #
# #*# # # # #*#*# # # #*# # #*#
#                             #
###############################