32 31 13
###############################
#$  *1   *** 2   **    *   ***#
# #*# #*# # # #*# # # #1#*# # #
#*    *I1    **s*1   *p*  b** #
#*# #*# #*#*#*# # #*#*# # # # #
#      I    1 *  *   I        #
#*# # #*# # # #*# #*# #*# # # #
#  1   *  **f   1   I   * **  #
# #*# #*# #*#*# # # # #1# # # #
#    *  1 *        **      ** #
# # # #*# # # #*# #*# # # # # #
#  1  * *       **    1**    *#
###############################