32 31 13
###############################
#$ *     3 *F* 1 *  2     ***p#
# # # #*# #*#*# #*# #*#*# #*#*#
#* **   2 *f*   *     3 ***   #
# #*#*# #4#*# #1#*# #*# # # #*#
#   *  1    *1   *W*  5    1 *#
#*# #*# # #*# # #*# #*# # #*#*#
# 1  **   8     b*   **    *  #
#*# # # #*# #*#*#*# # #*#*#*# #
#s*   7**D*      *   2   *M*  #
#*#*# #*#*#*# # #*# # # #*#*# #
#*     1 *    3 *B*      ** 6 #
###############################